█████████████████████████████
█           █               █
█  $        █               2
█           ████████        █
█       █                   █
█       █                   █
█   H   █                   █
█████████████████████████████