█████████████████████████
H                       █
█          █            █
█         █    X        █
█      ████    $$$$     █
█      █                █
█████████████████████████