█████████████████████████
H                       █
█B         █       X    █
█         █    X        █
█      ████    $$$$     █
█      █                █
█████████████████████████