█████████████████████████
H                       █
█B         █            █
█         █    X        █
█      ████    $$$$     █
█      █                █
█████████████████████████