█████████████████████████
H                       █
█B         █       X    █
█         █    X        █
█      ████    $$$$     █
█      █              E █
█████████████████████████